F 146,212,197
C 120,120,113
WE ./textures/scratch.xpm
SO ./textures/mario.xpm
NO ./textures/red.xpm
EA ./textures/yoshi.xpm

        1111111111111111111111111
        1000000000110000000000001
        1011000001110000000000001
        1001000000000000000000001
111111111011000001110000000000001
100000000011000001110111111011111
11110111111111011100000010001
11110111111111011101010010001
1100000011010101110000001000111
1000000000000000111111000010001
100000000000000011   1000000111
11000001110101011111111110N0111
11110111 1110101 101111010001
11111111 1111111 111111111111