NO ./textures/wood.xpm
SO ./textures/purplestone.xpm
WE ./textures/pillar.xpm
EA ./textures/wall_2.xpm

F 220  ,100  , 0
C 225 ,  30  , 0

1111111111111111
1010000000000001
1010000100000111
10100000N0000001
1000000000000000
1111111111111111
